0011010000011001000110111000000101011001111111111000010100101000001001001000101001100011011010101001
0111010010100101110001110100000001100000111110011100111000001000110101101100100000110010010110011011
1100001110010011000011110010001010010100001011100001010101111101010110001101011110000000101001011010
1110101001100101010100010111101111111100100000010100010011001000001001000110110100101001010110101010
1101101101000101100110000110110100000111111010111010010110111000010000111110011011111011101110100000
0111100101010100000110100011011011100010100101011110000101110010100101010111101001001111001010101010
1100001011000101001111111101100110110000000110111110101111110011111010101100010100000111001110110011
1011110100010100111011011101001101101111110100010011100110010111010111010000001110000010000000110001
1010100001100010001100101001100101110000100011111111101110100010001010011010010101011000111000010010
1011111110100101101101010100110011001110010100110011011010000100010011100110100111010111010110110111
1001101111100010010110111110100100100111001000010011100000011010010100001010010011010110111101100110
1001100001010100010000100011011110011001001010101100000000011110000000000110101101110110111100010000
1100000101101010101101010101000011100110010000101100111101110100010101100110111100010111110001010100
1100000010011011100111111011011001011000001010110001001010011110110001101010001001001011100100010110
0110001111101000001010110010010100011101101001000011010111001110101000101010100111101001111001010111
1010001011000011001000101111111101010011111100001010101010110000100000100000011101101100111110011111
1101111001000010101110111011110111111110010111100101100010001101110101010011010110100101010010111101
0010001011101011100000101000100100011011010010001100011110010110110011010001010000101000110110000001
0111000011110011001011011011110000101110100110110010000101001000010011101000110100110010000110001000
0010110000101111101100010111001101010010001111010100100011101011000011110111010110011100111110100001
0001111011010101001111101111001011110101101101101000010011111000000100001010100101001001100001011001
1010001110000100101100111101100000011111111000001001100011000101011001001111110011000111010011111101
1101011000011111101011101011011110101110010000100011001001000110110111100111110110010011010110100100
0101110010001110111010100100110110100101011011110111010011010100010011000111110000101100101000101010
1101001001110011111101010010111011100100000000011010110010000000101010000100100101011111111111111110
1101101000010111110001011000010100111011110000100000000011001101010111111011000110101111011110011001
1110110101111100010101100010101111011000000100001010110001010011110010001110111100010100110010110001
0111100110101100100001111101011000010011001100110001000011110000011010010101001110101011101011000000
0011101000101010001001111001010111010100010000100100000011110010011010001111101010111010111110111111
1101010010010111110000100100011100000100011010001010011100100000011010000111111100001000001000111010
0101110001010000111101100101010000001100001110011000101001111000000001111110101101010110000101110011
1000011011101111101101100001111011110100111010101110110011010100101010100101000001100110010011001110
1001100110010011001010000111000111100110111111011001110001011111110011111100000110010010110110001010
0101001100110100011101001000101111110000111101111011001001001100100101111011100001110010110101000101
1001111111010001111011111101110000001011101101001110110010011001111111011101100111111110100101101111
1000101000001000011110010111100011000010101110111011110110001101010000010110001011011001111011111011
0100100101001000100000010101110010000101110011011111011100110100010110001110011001000011111010011001
0010011010110010110010010011100111010100011000001100101111101100001101110111010101101100100101111011
1101011010000010011111101000000111110100110111110011101001001000011011011011010001101111100100001101
0001000100101110101101001001010101001000000011011000010110100100010011001110000000010001110101011111
1111111010111000011101100101001011111001101101010111011100000001000110011110010100010010010001010110
1110110110011010101001000001011001101100000001011100001000110110101011010011110101000101001010000110
1111001111110011001110011011111000010100011100010101000010010111011110101100110111010011110110011110
1010000100010001011010101011000100110100001101100010001101111011011100001000010111000101100001001011
0000011011011011101110100100010001000000100101111000111111011110000111011010011001011100100001011010
1011101111010011111100101000111010011100101001100100110101110000000110101010111011100111110101001001
0111011010011010010011101000011111001001101100111010000110011100011001100010011101110101111010111110
0100111000000000001110110101001010101011000000001010001111100011001100000001000011001111111100110110
1011100101011010111001000011010000100111110010110001001000101101001000101100011010001000000000110011
1011101111000010111011011101111010100111100101100101001111111010001100000010110001110000110111110011
1000010010011110100111110000011011010100110000011101110001010011000001001110000001000110111000010111
1101110101001011111001101011001111110101110101010011111101001110001010111101111010000011100010001010
0011100001001101100100101011010101000110100111000010111110001010110111110010011011010101101011101101
0000000110010100110010001000111010111011000001010111101010100010011011110111101110000001001101001010
0111111011001001110001111111110001100110011111110101011111010011001000100010011100001011010111101011
1010010110010110111011001000100101101111110111110011110001111110110010011000111100000100100000110010
0100110010010110111101001000111110011111101111001101000011000100110100011110001011110011110100001000
0010111010000011000101001111000101001001001111001111010110001001110111011110110101110001000000111010
1011001001110010100010000100110100110010110000101110000100101000100101101000000100111111001000000101
1000100011111100001011001101000101101100101111110000111110011110110101000101100110011011010010100110
1101111010110111000110011010001000110110001010000101011001010100101101010101101101110000111001111111
0000010000110100001100001100110101110001000001010001000010000010010010110101000011010100100011101101
1000110110011011100000011001001000101110110101101100110101001001010100001111111110111110000000100100
1101011110111110100001000011100000100000110110010111101000011001110101110101001100000100000111111101
1000001100100000001100011001010101100111110000011100101000001100011011010100100101100100110001100000
1000110001000010000000111100101111101000111100101111001110000000001000000111001111001001011111100100
0101000011010001000111010011011001011001010100100111010110001101111011001010100111111011000011111100
0101011010010011000101001001101010111001001010110000101110011001111001011111010101000000100010101111
0001010101001011011100100010000100011110011110111100100100101010111111100101000001110110110001011100
1100101101111111000110110110110100110110100001000100111010010111110011100111000010111001111001011011
1011100001001111110000100000011100110010100011111011000100010111010110110011101000110110010001011000
0010111101100101011101011101011011101101011101101100110011101000001011011011101011010010111001000110
1111011011111010010011100011100111001110010110001001100101111010011010011011010011110011011110110101
0111111011001011100001101010101100101000110101000110010100011100010011111110101010111101010011101000
1101110001100000000010011010011111000111101011000001011011001110010001101011100001111001001110011010
0110100000011011000111110110001111101001001101110111011100001001001110101110001011010011100100101010
1111110010011010010010001000100001100100000101100100101101001001010011101011000100001101101001100001
0010001010010011010010100000000100101110010110101101100101010100100101100111010110011010011110100010
0101000101110001010111010100100111001011011010100011100011000110101111111011011101011111000100001011
1011011000010101100111111101100001000011000000000111011100110100001011001000100010100100110100011011
1111100011001010011100110110011011110101110100010000110111101111010110010000101101111011110000001110
0101001001010001001001111011000001111011001001101111011011111111100011010001000011110111111011100111
0110110010000001111000101001100000011110001001000100111110011001010011000101111111011111011010011101
1110111111111110011100011101110011010001101110110110110010000001110111000101111000001010011001111110
0010010100100000111101110010011100110111001110101001000001111011110111110000110010011100011101100110
1000001011100011011000101011001100010100011111100011010001010010000111011001010000000011110101110100
0110011010000000011100110011010101010011000011111110001011101100101000010010111111000110001100110101
0001000111111100010010100110001101101010110011011000011000010111010001001010110000111110000111111000
0110110010000010111011111010110100100101111000001111100101011001000010011111011001001110111010110000
1000000010011010101001100010111111110100100110111110010100001011011101100010110101011110111011100101
0001010111111100001101111111111001100110111101111010001011000100111101110101001011110001001111111000
0010001011010011010000010111111010010010010110100001001111100111001111011011110111101111100110000010
1101101010111110000110100101101110101000101100001000110001101001001100101110111011111000101010100100
1111111001000110101000101011010110000001010101011001010101100010010101000000000101000010100011000101
1000010110000110111111000011000100010100101001100010101001101110000011011111011010010010000111111100
1010010101101000010011011011111100011111110101001111010101011011111110001000111100000001110111111000
1011110111111110100011011001001111110101011011101010010110110100000011010011010001110100101110100101
0110101001011100011111111001000100110110000100000001110110110101100111101100000100001001111011111100
1111010000101111000111000110100010100101100100010110011010000010011111011110001001011001010011111011
1001100010010111110101110101101001000100011011100110111100101000011001110110101101100001011100000111