1000100101000110101101011000100101001110110000111011001010010010101011101110001110111001000100000010
1100011100110011000000100101101010001010001110101010001011100000111100011010011110111001111001010011
0111010001101101111100010001000110101011110011000101110000011010100100000111001000110111111000100111
0010001011010111111101100000000001011101101110111000100001001011010101111011011000110000110101111011
0110010111011010111010100110110000000111110101111110110101100101110001010010111000000101000010100110
1000001110000000111011101110001010101101101001111101011001000100100000110011010000111101000000111011
1110011000100001011001111001010000000110010101011101001011111000100101010010110011011101100000001010
1010011111010010010010100000010111000100110010111111101001101000101001111010110101011000010110010101
1101111010111101011001000101001001110011000001000000111111100110001001001100010101100110101111001001
1101111001111101011101001001001111111010101110110101011111011111010011101001000100110110101001010101
1101000011101111101110011001101100100110100000111111110110110100100010111110101100010100110000100001
1110110101111100011110110010100110100100101101101110010110100000010100111100001010001100110011100000
1101010011100010110000000101011110011001011011011100001101111110011110101110001010001011100010000000
1110111111011000101011001000101110000111100101101100010111000000011010001010001100011000000001001100
1000000110000001011000101100010111010101111100111100110110101100011111011100001110001111010010110011
0000001011111111010101000010101011000111110111110101100110011111000011001000111000011011000100111011
1100011111101111100001010010100100001101110110000111101011001010000000111001011000111100001011101000
0011010101001101010000110011011111001111011000000011000001111000010011100111010101110100001110010101
0101101001010101110010110010000011010101110001000011110011110010101111011001110111110111110001000011
0110110101100010010000110101100111000110000010011111111001111110010100101000101111010001101100111010
0011010101011100110011100111100000011011000100111111111011000010010011010001011111001011100000110010
0110110011011100000000011100011110011001100101011101000100101011101000000000010010101100011111110011
0000100101101110001011110010010101111111011101101001001111111000011001110110111100111110111110100011
0100011100101100010010111010100110100110111110110010101101011111010000001001101100111011010010100011
0101001101001010011111111010000100011111001110011101101100110000000001111010101100110001100001111101
1011100000011111111100100110001000000101000000000010010001000011101100010100100011011100000011011001
1101011100110010101011000111110110000000000100110111001010010110100101000011011001000010011100110000
0000111001001001110100110110001110100000100011000000011001110100101000011111011011110011001101100111
1111101110011111101110010000011010001101111101101001111001011001100101100101011010111011011000000101
1011111001011010101100011001100110011101001101010111010000010001100101111010101000111110011011111100
0001001000011001000011101100100011110110110011110110011100011111010101001110101010001010100001101101
0100001111000110001010001101110101101101111100000101110110100011010001101001011101000100011111001111
0110011001110101110011010010100110111110100110111110010000000011000101110100010001110000001111110111
0110111111110000001111010000100110100010000010100111100101011000000011010000011000001010110010011011
0110010101001101000111011011001000010100000001100011011010111101110000000110101000100010010001010010
0011011010010101100001000001011111100001000110101001111000111001111011001100010101110111101110010000
0101000101000001111000111010011110000010111011110011011010110000100011010010110010111010000001100000
1010001011001010101010100110010110101010001110001010110111110100100010000101010101110010110011101110
0111010010011101001001111000101101100001000011100001010000010011101011001010010010001111001001010100
0011010010010001010111000011000111011010011110011000000000101010100110001001101110000111110001000000
1000001000100001000010110110111100111011111101100100100011010000010111001010111001000010100011110111
1001010010011101011111000011100000101110011010101111101001010010010111110001111100000111000011100101
0011101111011111110001011111110001000110001100101101010000011111011011000111101100111111111010000010
1011101000000010010011101000001110000010111011100111111010011010001110111100001110001111000111000001
0101110001010011010100101000101000101000011010111101010101011011000110011001100001010000100011100111
0001000101111011111000101000101011001000010101001101100100111001010000010001100110111001011100101000
1010101001001000000100101011111000011000011101001011010010000100100100001010110010101110110000100000
0110110001010000110001000001001111110101100111111111010001010010101010011111011001111110011101101010
1111001100011010101011110010111100110111110111001101111010100011110100000101011010001000100100011101
0001000100111101101100110000011111100010111110111100101000011111000010011000101000000101001111001101
1000111110111010000110010101100001111100100000001100001111110000011101011111101010011001011011010001
1111000110110011100000101001000001000001111010111010101000100010111101000100101101110111001101000100
1110101000001100110111000110110101000101111111011111111010011111101001101001000001000110100111101000
1001010001100010000010011011111111011010110011000100110110110000001100110011111111110011001110101111
1010000110000001101111101011010110010101100100111101100000000000001010000011010001111011100111110010
0001101111011011011100111110011011001110101010101100011110100110001011001000111000000011100010011011
1011100110001110001000100110001111011001001011110000111010010010111101001010000111011000001110000100
0010100111100010111110011101101001000111101100100010001011101001000100000011000010010010111111110110
0011110001001010110111011111101100110101101111000011101100100011010011001010110011000000010111000111
1100111111001100000001000010010111100010101000010101111000010111001111100111111101101001000111100100
1111010110111011011111111110001111011001100010101011010010110111101011010001111100100011010101101100
1110000100111010110110110000000010000110101101101000010000000001010100111000101000101000100011101111
0000110000010110000111000110111111100010000100000111010001111001010101110101010010110011110011110010
1000000110000011100101101111110001011110100001010001000111000100010010011001101001001011101110001101
1100110110111110010001101011100011011010110000010101110001101111111001101001100011111100001111010001
0010100000100000011111100000101110010111100000101010010100010010010001100100000000101110001000110110
0100000110001000000011100011000101000001111111010100000111000101101101000111100110110011001011110010
1110010110000100101101010111001110110000111101010010110101111101000100000100011110011111101111111101
0101111110101001101001010111110100111110110101110101100110010001000110000111001011110100000100000010
0101111100011101100101011011000100001100000100000011101111101010000001111011010110011110011101100101
1101000001100110111011010111101111111010011000101101001010110110100010101101110100101111111010101100
0111101010001100001011010111011110000010011010010110010101110000110011001011010011100101010010011101
1111000110011001101011100011001000000011111110001000111111100100010011100001011010101111111010110111
0110011100100110110010101111100000001000011001011110101011110011100011101100101001011101000110111100
1001000000111111001101101101111000100010011101010001000000111110110100011111111010011000100111011001
1111111101011011110001100001000110001111101000101111010001111100011010001111111001011010011100011001
1101110010110001001110011110111011000100110010110011011011111101110000110100000011011001110011110001
0111101010010101111001101010101000100100101110011010011011001100011101100011100010010001100111011010
0000110110010100010001101000111000101011010111001111111011010001011001111010001010111110011100111110
1000110110011111111010011010011000101011011100110111010100000000001011110011001011110000010001101011
0011101110000101111101011110101111000101001111010010100110101010110001101011111010000100001000110001
0100000110101011000100001100011000011100011110011010001101011111100001000000010011110111001000100100
1111100010000100111111101001100010100001011001100101001101000110111010010110111111110010101001011110
0100111101000010001110110000111100000001001100010001100001100000000110000001001001111001110000111011
1001000101101000010000001000011100000001001001100000110101001011000110000101010111100111001001010101
1001111011100110010111111000110111001110010110110001100010101101101000011010111011001110100000100010
0010001111110011111111101101001011100011011011101001010001010001110101000100101101111101110000011001
1101010001010011110000100011111011000001010000111010011110111101001001000010101110111010100000000111
0010010011110101101111100011100111000111011111010010010010001001101101100110001010000101000100011100
0001101011110001101101100100100011000100011100110000000001011000110010000000001101111000110111101011
1101001001110011001000000101101011101111101001000010111000010101110111101001010000011001100011110111
0101010101100111011010010011001110101010110000101100011101101101010010011010110101111010000100101111
0111100001100101100000111011111101010111110100000101011001010100101011100110101001011010111010011110
1000001011111110000111100110111000101111100110011010011100111111111100111011011101101001000001100101
1110001101000111111100011110100000110001001011111101000111110011101110010010000110110011011101100110
1111010101011000001011101100010011110110111001111111101111111010111101001010001100010011011001010100
1100000100011011001111001011011011011000011000000001110001011111010101111011000010000100101010001011
1100100110110101111011010101110010001100000010010010101111010110111001111110101110001110010000010111
1101010101010111000101010010110011001000000101100101100011010010000111010111011110000001000111010101
0000011101100001001011110010110101110000110110101100111111011100101010110001011011000011011011000111
