1111111100222222222210020022220000000000000000000110000111111011111110010110000000000011010001110000
1111111111222212222221020002220000000000000000011111101111111111111111011110000000000111110111111111
1111111111222222222222222222202000000000000000011011111111111111111111111110000000000001110111111111
1110122111102222211222222222000000000000000001111011111111111111111111111111000000001111100111111111
1111122211122222222222222222220000000000000000000011110111111111111111111111111000001110011111111111
1112222221222222222222222202000000000000000000000011111111111111111111111111111000000000101100111111
2111222222222222222222222222220000000000000000000001111111111111111110111000000000100000111000111111
2122221222222222222222222222200000000000000000000000111111111111111111111000000000002002111111110111
2222222222222222222222222222202000000000000000000000111111111110001111001100000000022222111101111111
2222222222222222111100001122222000000000000000000000011111111111100000001000000000222200110100111101
1122122222222222222222222110000000000000000000000000011111111111111110000000000022222220000000000000
0122222222222222222222222222200000000000000000000010111211111111111111000000000022222220000000000000
1122222212222222222222222222220000000000000000000001111121111111111111112020002222222220220000000000
1112222222222222222222211111220000000000000000000001111111111111111111112220022222222022222000000000
0222222222222222222222211101100000000000000000000000011111111111111111000222222222220222200000000000
0022222222222222200222210000000000000000000000000000111111111111111111222222222222222222200000000000
0111012212222222222222220000000000000000000000022222000011211111111101202222222222222222220000000000
0111122111222222222112221111000000000000000000022222022211111111111122212222222222222222222000022000
1111111111112222222122221110000001110000000000222220222222211211211222222222222222222222222222222222
0011111111111122222222222100000001110000000022200222222222221211121222222222222222222222222222222222
0001110111111222222220111101000011110011111122222222222222211111111000222222222222222222222222222222
0000110000111222222201111111000111110001122222222222222222221111111100222222222222222222222222222222
0000111000111222222001111111011111111001101222222222222222211111111000222222222222022222222222222002
0001110001111222222000111110111111111111222220222222222211111111110000222222222222222222222000000000
0000000001111222222100111111111111111111102022200022022222111111122000022222222222222222222222222220
0000000001111210001110111111111111111111000000000022222122111111100000022222222222222222222222222220
0000000000000110011111111111111111100111100000000222222212212221100000022202222222222222222222222200
0000000000000000111111111111111111111111100000000222222222212222110000022002222222222222222222222220
0000000000000000010111111111111111111111000002202222222222211222220000022000022222222222222222222220
0000000000000000001111111111111000000000011000002222222222222222220000000002222222222222222222222000
0000000000000000001011111111111111111111111112220222222222222222222000002222222222222222222222202000
0000000000000000011011111111111111111111111110222222022222222222222200000222222202222022222222222200
0000000000000000000000110111111111111111110022222222222222222222222220000022002222222220022222222200
0000000000000000000000111111111111111111100022222222222222222222222222222000002222222222022222222000
0000000000000000000000111011111011111111100022222222202222222222222222222000000000222222222000202000
0000000000000000000000110111111111111111100002222212222211211222222222022000000000220022222020220000
0000000000000000000000111101111111111111110002222221002222222211122222022200000000222000222220220000
0000000000000000000000111111111111111111111000222121222222222222222220022200000000000000222202222222
0000000000000000000000010111111011111000110000222111222222222222222222022200000000000000022220222222
0000000000000000000000000011110111100000111000022222211122222222222222000000000000000022022222222222
0000000000000000000000000011100000110000100000022222211222222222222211010000000000000000020022222222
0000000000000000000000000011111000000000000000200222222222222222212211111000000000000002222222222222
0000000000000000000000000001111110000000000000002221222222222222202211111000000000000202222222222222
2220000000000000002000000001111110000000000000012221212222222222122200000110000000000222222222222222
2220000000000000022000011111001100000000000000012122212112222222222111110000000000000022222222222222
0222000000000000222000000011101000000000000111111222221122222211112221111000000000000002222222222222
0222220022200000222220200000001000000200000011110022221222222211112221111110000000000022222222000000
2220222022000000222200200000000000000200000011110022021112221111111211110100000000000000200000022222
2220222022220000022222200002222220220220000011102222211111222111111111111110000000000000002222222222
2222222222222202022222222202222220222220000111000011011111111111111110111111000000000002222200222222
2222222222222222222222222222222222222022200111000111011111111111111110001000000000000000220000222222
2222222222222222222222222222222222022200000011011111001111111111111110000000000000000000020000222220
2222222222222222222222222222220000000220000011111111001111111111101100000000000000000000000000022222
2222222222220222222222222222222222000200000011101111111111111111100100000000000000000000000002222222
0000222222222222222222222222000000000200000001111111011111111111110000000001000000000000000002222222
2222222222222222222222220000022222002200000000111111011111111111111100100011100000000000000000222222
2222222222222222222222222222222222002000000000011111111111111111111111110111100000000000000000222200
2222222222222222222222222222222222000000000000001111111111111111111111111111000000000000000000020000
2222222222222222222222222222222222200000000000001111111111111111111111111110000000000000000000000000
2222222222222220222222222222022222200000000000000111111111000000000111101000001000000000000000000000
2222222222222222222222222222222202200000000000000111111111111111110000001000101000000000000000000000
2222222222222222222022222222222220000000000000000111111111111111111110000010000000000000000000000000
2222222222222222221200022222222200200000000000000000111111111111011010011110000000000000000000000000
2222222222222202211100002222202000000000000000000000111111111111111000001000000000000000000000000000
2222222222222202222222220222220000200200000000000000111111111111111000000000000000000000000000000000
2222222222222222222222222222222000222200000000000001111111111001111100000000000000000000000000000000
2222222222222222222202222222222000222000000000001111110111111111111100000000000000000000000000000000
2222022222202220011202222222202000000000000000111100110010222000011100000000000000000000000000000000
2200022222202222011111002222200000000000000001111000011100222200000200000020000000000000000000000000
2220022222022222011111102022220000000000000000111110001100222200000200002222000000000000000000000000
0000002222022222111111100222200000000000000000010012001000222200000220022000000000000000000000000000
0000002222000001111110000022200000000000000000000022222222222222222220222000000000000000000000000000
0000000000000011111110000000011110000000000000000220222222220022222222220000000000000000000000000000
0000000000000001111111111111111100000000000000002200000202222222222222222200000000000000000000000000
0000000000000011111111111111111111110000000000200000000222222222222222020022000000000000000000000000
0000000000000011111111111111111111110000000000000000002222222222222222220022220000000000000000000000
0000000000000111111111111111111101110000000000000000222222222222202222200222220000000000000000000000
0000000000000111111111111111111111010000000000000000222222222222222222220222200000000000000000000000
0000000000000111111111111111111111000000000000000002222222222222222222222220000000000000000000000000
0000000000000111111110000111111111000000000000000002222222222222222222222220000000000000000000000000
0000000000111111111111110000001111000000000000000000000222222222222000000000000000000000000000000000
0000000000011111111111111111100000000000000000000000022222222222222222222222220000000000000000000000
0000000000001111111111110111111100000000000000000000222222222222222222222200000000000000000000000000
0000000000001111111111111111111100000000000000000000002222222222222222222200000000000000000000000000
0000000000111111111111111111110100000000000000000000002222222222222222222200000000000000000000000000
0000011100111111111111111111100100000000000000000000022202222222220222222200000000000000000000000000
0000001101111111111101111111100110000000000000000000222202222222222222222200022000000000000000000000
0000000111111111111101110011100100000000000000000000000222222222222002202222222000000000000000000000
0000000010111111111111111011100100000000000000000000002222222022222202222200222202000000000000000000
0000111111111111111111111001101100000000000000000000002222002022222202222222222222200220000000000000
0011111111111111111111011001000110000000000000000000000002002222222222222222222222222220000000000000
0111111111111111111111100000000000000000000000000000000000222202222222222222222222222020000000000000
0001111101111111111111100000000000000000000000000000000000022202222222222222222222222222000000000000
0001111111111111111110000000000000000000000000000000000000000002222222222222222222222200000000000000
0111110000111000110111001100000000000000000000000000000000000002222222222222222222222000000000000000
0001000111111110111111101110000000000000000000000000000000000002222222220000000000000000000000000000
0001011111111111111111100111110000000000000000000000000000000000222222222222222222222200000000000000
0001001111111111111111110001000000000000000000000000000000000000002222222222222222222220000000000000
1111111111111111111111111100000000000000000000000000000000000000022222222222222222222000000000000000
0111011011111111110101111100000000000000000000000000000000000000020022222222222222220000000000000000
