1001111111
0110110100
1000001000
1100111010
1001101001
0010100011
0010101110
1001101110
0000100111
1000000110
