0000000000000000000000000000000000000000000000000000000000022222222222002222222222200000000000000000
0000000000000000000000000000000000000000000000000000000000002222222222222222222222222000000000000000
0000000000000000000000000000000000000000000000011100000000012222222222222222222222220000000000000000
0000000000000000000000000000001000000000000000011110000111122222222212222222222222110001011110100000
0000000000000000000000000000001101111000000000111110000111012222222212222222202222111111111101100000
0000000000000000000000000000011111111011100001111100000101022222222222222222222222111111111111000000
0000000000000000000000200000001111110111111111110000111222122222222222222222222222111111111111100000
0000000000000000000000200000000001110111111111110121112222222222222222222222222222211110111101100000
0000000000000000000002200000000001111111111111110111122221222222222222222222222222221111111111111000
0000000000000000000022200022221220011111111111111111211221222222222222222222222222211111110111111111
0000000000000000022222222222222200000111111111111111111222222222222222222222222222111111111111111100
0000000000000002022222222222222210000111111111111111111122222222222222222222020211111111111111100000
0000000000000002222222022222212222000111111111111111211122222222222222222222222111111110010111000000
0000000000002202222222022222212222000111111111111111011122222222222222222222222111110000001111111000
0000000000002202222222022222010222111111111111111111111112222222222222222222221111111111101111110000
0000000220002222022222222222222222111111111111111111111112222222222222222222222111111111111111111000
0000000022022222222222222222222222111111110000000001011112222222222222222222220111111111111110110000
0000000022222222222222222222222222111111111111111100111111122222222222222222222001111111111111100000
0000000220222222000222222222222222111111111111111112122111122222222222222222222001111111111111000000
0000002222222022200022222222222222111111111111111112221121222222222222222100222001111111111111100000
0002002220222222222222222222222222111111111111111111111111222222222222222102222001111011111111000000
0002002222222222222222222222222201111111111111111111112111122222222222222200020011100001111110000000
0002222222222222222222200000002001111111111111101111111111122222202200222000020011100011111111000000
0000000222222222222222222222200011111111111101100011122111222222122222221000020011000001111111000000
0000000002222222222222222222211111111111111111111110222222212121122222111100000000000001111100000000
0022002222222222222222222221220000111111011111111100002021112222111222111110000000000001110100000000
0020002222222222222222222201000000111111111111111111222202111000111222111000000000000011110000000000
0222202222222222222222222011110001111111111102111201222221111112211222221000000000000001100000000000
2222222222220222222222222010010011011111111002211222222221111122211222220000000000000001100000000000
2222222222222222222222222200111111111111111111111022222222211222222222222000000000000001100000000000
0000222222222222222222222000011111111110011111112222222222222222222222222000000000000000000000000000
0000222222222222222222022011111111111110111111100222222222222222222222222000000000000000000000000000
0000000222222222222222221111111111111111111111100222202222222222222222220000000000000000000000000000
0000000222222222222222021111111111011111111110111122002222222222222202220000000000000000000000000000
0000002222222222222222221111111111111111111110111112202222222222220002200000000000000000000000000000
0000000222222222222221111111111111111111111110110000002222220222000002200000000000000000000000000000
0000000222222222222222111111111111111111111111111100002222222222000002000000000000000000000000000000
0000000022222222222222201110111111111111111111111000000222022222000000000000000000000000000000000000
0000000022222222202202200110000000111000011111000000000222220222000000000000000000000000000000000000
0000000022222222222000100000011111111111111110000000000022220000000000000000000000000000000000000000
0000000022222202220000000111111111111111111110000000000022022000000000000000000000000000000000000000
0000000022222202222000111111111111111111110111000000000022222000000000000000000000000000000000000202
0000000000222000222000011110111111111111110000000000000002222000000000000000000000000000000000022222
0000000000222000020000001111111111111111111000000000000000222000000000000000000000000000000002222222
0000000000022200000000000101100111111111111000000000000000000000000000000000000000000000000022222222
0000000000000200000000000000111111111111000000000000000000000000000000000000000000002220000002222222
0000000000000000000000000000011111111111000000000000000000000000000000000022202202222220000002222222
0000000000000000000000000000001111111111100000000000000000000000000000000022222222222220000222222222
0000000000000000000000000000001101110000000000000000000000000000000000000002222222222222222222222222
0000000000000000000000000000001111110000000000000000000000000000000000000000022222222222222222222222
0000000000000000000000000000000001100000000000000000000000000000000000000000022222222222222222222222
0000000000000000000000000000000000000000000000000000000000111100000000000000222222222222222222222222
0000000000000000000000000220000000220000000000000000000000111010000000000002222222222222222222222222
0000000000000000000000000022200220220000000000000000000000011010000000000102222222222222222222222222
0000000000000000000001000222002222220000000000000000000000111111111000000112222222222222222222222200
0000000002020000000011102222202222000000000000000000000000111111111000011112222222222222222222222220
0000000222222000000111222222222222000000000000000000000001111101100000011111112222222222222221022222
0000000022220000200122222222222222200000000000000000011111111111111111111121111222222222211122222222
0200020022000000222122222222222222200000000000000000001111111111111111110001110022222000011122222222
2222220022202222222122222222222222222000000000000000011111111111111100111111112222222222211112222222
2222220022200222222222222222222222222200000000000000001111111111111111111111122222222222111122222222
2222222222220222222221222222222222020220000000000000001111111111111111111111122222222222111222222222
2222222222222222222222222222222222022222200000000000011111111111111111111111222222222222211122222222
2222222222222202222222222222222222222222222200000001111111100111111111111111222222222222111111222222
2222222222202222222222222222222222222222222200000000101000001111000001111110020002222222111111222111
2222222222202220222221111021022222222222220220000000100001111111111111111111100002222221111111211111
2222222222222222011111222222222222222222222200000000002111111111111111111111100002222202111111111111
2222000000002222211122222222222222222222222222222220021111111111111111111111110022222201111111111110
2222222222202221112222222222222222222222222222222222221111111111111111111111110022002111211112200000
2222222222222202222222222222222222212222222222222222222211111111111111111100000022002111111111111111
2222222222222212222222222222222221121122222222222222222000111111111111011101000002001111111111111110
2222222222222202222012122222222222222012222222222222222011111111111111111111000000000011111111111110
2222222222222222222222222222222222210002222222222222222201011111111111111000000000000111111111111110
2222222222222222222222222222222222111222222222222222222001111111111111111101110000000011111111111110
2222222222222222222222222222222211211222222222222222220001111111111111111111110000000011111111111110
0222022222222222222202222222222222111122222222222220000111111111111111100111110000000001111110111110
2222022222222222222212222222222222111222222200000000222111111111111101111011000000000000010110111110
2202222222222222222222222222222222222222222222222222221111011111000101111011100000000000100111111110
2202222222222222222222222222222221122222222222222222222211001111111111111111100000000000000011111100
0000222002221222222222222222222111222222222222222222222211111111111111111111000000000000000000001110
0000222001011221122221111122222211222222222222222222011211111111111111100111000000000000000000001100
0000000000011111222222222222222222222022222222222222212011111111111111110000000000000000000000000110
0000000000000112222222222222222222200000222222222002111010011111111111111110000000000000000000000000
0000000000002222222222222222222022200000222222220002211110111111111101011000000000000000000000000000
0000000000002222221222222222222022200000222222220000211111111111111111110000000000000000000000000000
0000000000002022222222222222222202222002222222000000211110101111111110110000000000000000000000000000
0000000000022222222222222222122222222200220222000000001111111111111110110000000000000000000000000000
0000002220022202222222222222220222222202222222000000001111111111111100011000000000000000000000000000
0000000200022222222222222222222220220202220000000000001111011110001110000000000000000000000000000000
0000000000022222222222222222200022200000000000000000011001100000001110000000000000000000000000000000
0000000000022222022222222222222222000200000000000000001000000000000000000000000000000000000000000000
0000000000000222022222222222220022200000000000000000010000000000000000000000000000000000000000000000
0000000000002222222222222222222222200000000000000000000000000000000000000000000000000000000000000000
0000000000000222222222222222222000200000000000000000000000000000000000000000000000000000000000000000
0000000000000220222222222222220000220000000000000000000000000000000000000000000000000000000000000000
0000000000000020222222222222220022222200000000000000000000000000000000000000000000000000000000000000
0000000000000222202222222222220022222220000000000000000000000000000000000000000000000000000000000000
0000000000002222222222222220000020022000000000000000000000000000000000000000000000000000000000000000
0000000000000002222222200000222000000000000000000000000000000000000000000000000000000000000000000000
0000000000000002222222222222222222020000000000000000000000000000000000000000000000000000000000000000
