0000000000000000222222222222222222000200000000000000001000001111111111111110000100001001000000000000
0000000000000022222222222222222222000200000000000000011110000111111111111111111110000000011100000000
0000000000000022222222222222222022222220000000000000001110100110111111111111111101111111011100000000
0000000000000002222222220000000022222200000000000000000111111111111111111111111111111111111000000000
0000000000020002222222222222222222222000000000000000000001111111111111111111111111111111100000000000
0000000022220222222222222222222222222000000000000000000001111111111111111111111011100001100000000002
0002222222222222222222222222222222222202200000000000000011111111111111111111111111110011111002000222
0000222222022222222202222222222222002200000000000000001111111111111111111111111111100011102002000022
0222222222022222222202222222222222202200000000000000001111111111111111111111111011100000022022222222
0022222222222222022222222222200002202222200000000000001111111111111111111111011111100000222222222222
0222222222222222222222222222200000200002200000000000001111111111111111111111111111100022222222222220
2222222222222222222222222222222022200000000000000000000111111111111111111110000010000020022222222222
2222222222222222222222200222222222200000000000000000000001111111111111111111111000000022222222222222
0222222222222222222222222222222002000000000000000000000001111111111111111111111110000002222222222222
0000000000220002222222222220022222000000000000000000000001111111111101111111111100000002222222222222
2222222222222222222222022000020000000000000000000000000000001111111111100111110000000000000002220000
0222222222222222222222220000000000000000000000000000000000001111111211111111010000000022222222222222
0220222222222222202222020000000000000000000000000000000000022111111111011111010000000002222222222222
0000222222222222222220000000000000000000000000000000022001111111111111011011000001110002222202222222
0000222222222222222220000000000000000000000000000000022200111111111111111000000011111002222202222222
0000202022222222222222000000000000000000000000000002222222002211111111110111011111110022202200222222
0000200202222222222220000000000000000000000000000000222222221111121111111101111111111002222200222222
0000002222222222222220000000000000000000000000000000222202222221111111111101111111111020022220220222
0000000222222222220020000000000000000000000000000000022222222222112112121111111111111020020022222222
0000002222202222222222200000000000000000000000020000022222222222221122221111111101111121220202222222
0000000002222222102222001000000000000000000000022000022222222222211111222111111111111111122222222220
0000000002022222112221101110000000000000000000222002222222222222222122221221111111111110222222202220
0000000002222120111111111110000000000000000000022200222222222221111122221222111212221210220002220000
0000000000000100111111111011000000000000000222022222222222022222222222222221122222222222022000000000
0000000000000110111111111000000000000000000002222222222222022222222221112222222222222222222200000000
0000000000001111111101111000000000000000000022022202222222222222222222111122122222122222222000000000
0000000001111111111111111011012220000000002022222222222222222222221222221121122222222222222000000000
0000001111101111111111111111022200000000002222002222222202222222221222222211121122222222202200000000
0000001111111111111111111112112222000000002222202222222222222222222222221221122222222222000000000000
0000011111111111111111111112222222220000002222222222202222222222222222222221222222222222000002000000
0000011111111111111112111112222222200000222222222222222222222222022012222221222222222220222202000000
0000011111111111111112222222222222220000222222222022222222222222222011022222222222222222222200000000
0000111011000111111111122222222222220000222222222222222222222222222220022222222222222222200222000000
0001111111110011111111222220222222200000222202222222222222222222222222222222222222222222200000000020
0001111111111011100001222222022222222200220022022222222222222222220002222222222222222222000002220000
0000011110011111111122222222222222222200220222222222222222222222220002022222222222200000022220220000
0000011110011111111122222222222222222200222222222222222222222222222220020222222222222222222222222000
0000011110111111111221222222222222222222222222222200000000000122111111102222222222222222222222220000
0000011011110011111122222222222222222222222222222222222222112101111001102002222222222222220220000000
0000110111111111112222222222222222222222222222222222222222111111111111100002222222222222222222000000
0000100011111111022222222222222222222222222222222222221221111110111111002002122222222222200200000000
0000100011110111112211022222222222222222222222222222111111111101111111122202122222222222222220000000
0000000111110010112221002222222000000022222222220222221111111111111111122221122222222222222220000000
0000000111110000112221102222222222222222222222222222221111111111111111111121122220222222222220000000
0000000000100000011111122222222222222200222222200222211111111111111111112222222222222222222220000000
0000000000000000011111122222222222222220202122220222211111111111111111111222222222222222222222200000
0000000000000000111111122222222222222222221102222222211121111111111111111110022222222220222222220000
0000000000000000011001222222222222200020221111111222012111111111111111111111120222222222222222220000
0000000000000000011102220022222222200222222111111112222011111111111111111101000222222222222222222020
0000000000000000011102222122222202222220022111111112221211111111111111111101222222222222222222222000
0000000000000000000002222022222222222220011111022110221111111111000000011100222222222222222022222200
0000000000000000000001222222222222222221011111122010011110111111111111011110022222222220222222222220
0000000000000000000000210222222222221221011111100010000111111111111111000010002222222222222222222200
0000000000000000000000000002220022221211111111111110000011111111111111111000000022222222222222220200
0000000000000000000000000110210002222222211011010110000111111111111111111110222222222222222222220000
0000000000000000000000000111111001222222211011111110011110111111111111111111222202222222222222220000
0000000000000000000000000000111011011112221111111110001110111111111111111002222202222222222222220000
0000000000000000000000000000011111111111211111111110000000011111111111101002222222222222222222222200
0000000000000000000000000000111111111111111111111111110000001111111111000000222222222222222222022220
0000000000000000000000000000011111111111111111111111101100111111111111100002222222222222222222222220
0000000000000000000000000000001111111111111000000000001100100111111111110222222222222222222222222220
0000000000000000000000000000010111101111111111111100000000000011111111122200222222222222222222222200
0000000000000020000000000000000001111111111111111110110000000001111201222222222222222222222222222020
0000000000000222000000000000001100111111111111111111110000000022112222222222222222222222222222222020
0000000000000022200022200000000111111111111111111111111000000222222222222222222222222222222222220022
0000000000000022222222000000000111111111111111111111110000000022222222222222222222222222222020000222
0000000000000022022220000000000110111111111111111111100000000022222222222220222222222222222222222222
0000000000000022022220000220000000011111111111111111100000000022222222222222222222222022222222222222
0000000000000022222002222220000001011111111111111111000000000222222222222222220222222222222222222220
0000000000000022222022222220220001101111111111111001000000000022222222222222221122222222222222222222
0000000000000002222022220020222000111011111111100000000000000000022222220000011002222222222222222222
0000000000200002222220020002222000111111001110000000000000000002222222222222222201102222022222222222
0000000000202222222222222222222211110100111110000000000000000000222222222222222222222222222222222222
0000000000202222222222222222220111011100111111000000000000222222222222222222222221220222222222222222
0000000000222222222222222222222011100000111111000000000000202222222222222222222121222222222222222222
0000000000222222222222222222222211000000000110000000000000202222222222222222202222222222222222222222
0000002200002222222222222222200022000000000000000000000000222222222222222201112222222222222222222222
0000002202002222222222222222222222000000000000000000000022220022222222222222221222222222222222222222
0000022002222222222222222222222222000000000000000000000002220022222222222222221111222222222222222222
0002022222222222222222222222222220000000000000000000000000020022022222222222221110222222222222222222
0002000002000000222000022222222222220000000000000000000000022202001222222222221111122222222222222222
0200020000000222222222222222222222200000000000000000000000000000001112222221222111122122222200000220
0020000002222222222222222222222200220000000000000000000000000000011112222222211111122122222222222222
0000000222222222222222222022222000000000000000000000000000000000000012222222211122211122222222222222
0000002222222222222222222022222000000000000000000000000000000000011112221222211122221122222222222222
0000002222222222222222222222222000000000000000000000000000000000011011222202000022222222222222222222
0000002202222222222222222022202000000000000000000000000000000000011011212212111111222222222222222222
0000002222222022222222222222200000000000000000000000000000000000000011112112111111222222222222222222
0000000222222222202000222222002000000000000000000000000000000000000011111111111111112222012222222222
0000000222200222200000222222222000000000000000000000000000000000000111111111111111111000010222222222
0000000000002222222000202222220000000000000000000000000000000000000111111111111111100000000222222222
0000000000002222222000000022000000000000000000000000000000000000000011111111111111100000000022222202
0000000000000222220000000000000000000000000000000000000000000000000000011111111111110000000022020222
0000000000000222200000000000000000000000000000000000000000000000000000001111111111100000000222020222
0000000000000022200000000000000000000000000000000000000000000000000000001101111100000000002200000220
