0000000000011202211122221112211110222200000000000000000000000000000000000000000000000000000000000022
0000000000001111111111111111211112222222200000000000000000000000000000000000000000000000002222000022
0000000000002021111111111111111122222220222000000000000000000000000000000000000000000000000202000022
0000000000002211111111111111111222222222200000000000000000000000000000000000000000000000002222000222
0000000000001111111111111111111011000000000000000000000000000000000000000000000000000000002222000200
0000000000011111111111111111111111222200000000000000000000000000000000000000000000000000002222202220
0000000000001111111111111221111112222000000000000000000000000000000000000000000000000002222222022222
0000000000001111111111111221111112122000000000000000000000000000000000000000000000000001020222022222
0000000000001211111111111221122112200000000000000000000000000000000000000000000000000101222022222222
0000000000000111111111111112202112200000000000000000000000000000000000000000000000000101110222222222
0000000000001011021111111211220111222000000000000000000000000000000000000000000000000100112222222222
0000000000001122111111111111222221222220000000000000000000000000000000000000000011111120112222222220
0000000000011111111111111111222220002222000000000000000000000000000000000000000001111111112222222220
0000002001111111111111112112212220002222200000000000000000000000000000000000000011111111111121122222
0000002211111111111111111112212220000020220000000000000000000000000000000000000011111111111111122222
0000002211111111111111011122222220220000220000000000000000000000000000000000000011111111111111112122
0000000111111111111111112222222220222222220000000000000000000000000000000000000011111111111111111112
0000002211111111111222222222222220222202220000000000000000000000000000000000001011111111111111111122
0000002111111112112221122222222220222222200000000000000000000000000000000000001111111111111111111122
0000000111111111112222222222222222222222200000000000000000000000000000000000011101111111111111111112
2222211111121111112222222222222222222222200000000000000000000000000000000000011111111111111111111122
0222220001122221002222222222222222222222200000000000000000000000000000000000000111111111111111111112
2022020002211111112222222222222222222222200000000000000000000000000000000000001111111122111121112111
2222221111111111122222222222222222222222220000000000000000000000000000000000000111111112222111111112
0221221111111112222222122222222222222222222000000000000000000000000000000000000011111111222212111111
0011121111111122111122222222222222222222220200000000000000000000000000000011111111111111121222111111
0011111111111111112122222222222222222222222222200000000000000000000000000111111111111111122222221111
0211122211111112222222222222222222222222222222200000000000000000000000000001111111111111122221111110
2211122221111222222222222222222222222222222222000000000000000000000000000111101111111211122222111222
1211222211221122211222222222222222222222222222200000000000000000000000000000001111111222222222211222
2111222111221112222222222222222222222222220222220000000000000000000000000000001111121122222222222221
0221221111221111122222222222222222222222222222220000000000000000000000000000011111122212222222222200
0222222211111111122222222222222222222222222222200000000000000000000000000000001111122222222222222222
0222222211111111222222222222222222222222222222220000000000000000000000000000111111122222222222222222
0222222221222222222222222222222222222222222222220000000000000000000000000000111111222222222222222220
0022222200222222222222222222222222222222222222220000000000000000000000000001111111222222222222222220
0222022222222222222222222222222222222222222222222000000000000000000000000001111111222222222222222222
0000022222222222222222222222222222222222222222222220000000000000000000000000011111222222222222222221
0000022222200222222000222222222222222222222222222220000000000000000000000000001111122122211221112222
0000022002222222222222222222222022222222222222222200000000000000000000000000000221112111112222222222
0000022002222222222222222222222222222222222200000000000000000000000000000000010112211122222222222222
0000000022222222222222222222222222222222222000000000000000000000000000000000010121111222222222222222
0000000000000222222222222222222222222222222000000000000000000000000000000000110111111222222222222222
0000000000000000222222222220222222222222222000000000000000000000000000000000100111122222122222222222
0000000000000000222222222222222222220222220000000000000000000000000000000011100011122222222222222200
0000000000000002222222222222222222200222220000000000000000000000000111100011101111222222212222222220
0000000100000022222000222202122222000222220000000000000000000000000110100111111111111222112222222220
0000000111111222222022222222222000000222220000000000000000000000000011101111111111000011122222022200
0000000111111112200022222221021110002222200000000000000000000000001001111111111111000000022222222200
0000000111111111110222222011111110022022200000000000000000000000001111111111111111000000000222200000
0000000001011111111112202011111110000002200000000000000000000001111111111111111111110000000200000000
0000011111111111111100002211110010000000000000000000000000000000111111111111111111100000000000000000
0000000000111111111100111111111100000000000000000000000000000010111111111111111111110000000000000000
0000000000111111111111111111111100000000000000000000000000000011011111111111111111010000000000000000
0000000000111111111111101111111111111000000000000000000000000111111111111111111111010000000000000000
0000011010011111111111111111111111011001000000000000000000000000001100111111000000010000000000000000
0000111111111111111111111111111111110000000000000000000000000000000001111111111111110000000000000000
0000011111111111111111111111111111110010000000000000000000000000000111011111111111110000000000000000
0000001111111011111111111111000001000110000000000000000000000000000010011111111111111000000000000000
0000011111111111111111111111111100011100010000000000000000000000111000111111111111111000000000000000
0011111111111110000111111111111111110001010000000000000000000000110000111111111111111000000000000000
0110011111111111111111111111111111111111110000000000000000000001100000111111111111110000000000000000
0000000111110111111111111111111111111110010000000000000000000000000000000011110110000000000000000000
0000000111111111111111111111111111111110010000000000000000000000000000000011111100000000000000000000
0011000111111111111111111111111111111111110000000000000000000000000000000011101000000000000000000000
1111100111011111111111111111111111111210010000000000000000000000000000000011100000000000000000000000
1111111111111111111111111111111111111220220000000000000000000000000000000111000000000000000000000000
1111111111111111111111111111111111112222220000111100000000000000000000000111000000000000000000000000
0011100000000001111111111112111111122222222220010000000000000000000000001111000000000000000000000000
0011110000000001111111121112221111122222222221110000000000000000000000001110000000000000000000000000
0111010000000001111111121222211111122222222222110000000000000000000000000000000000000000000000000000
0010000000000000121111111222211122222201111111110000000000000000000000000000000000000000000000000000
0000000000001111121111112222211122221112222221111000001000000000000000000000000000000000000000000000
0000000000011110111111112222211211111222222112210011111010000000000000000000000000000000000000000000
0000000000001111111111222222211222222222211112210011110010000000000000000000000000000000000000000000
0000000000001111111101222222222222222222221112021111111110000000000000000000000000000000000000000000
0000000000001111111002222222222222222222222211121111111111000000000000000000000000000000000000000000
0000000000000100000001222222222222222222222111111111111110000000000000000000000000000000000000000000
0000000000000000000022221222222222222222222000001111111100000000000000000000000000000000000000000000
0000000000000000001112222222222222222222222111111111111000000000000000000000000000000000000000000000
0000000000000000000112222211222222222222221111111010111100000000000000000000000000000000000000000000
0000000000000000001111111112222222222221211111111111111111000000000000000000000000000000000000000000
0000000000000000001111111112211222222211111111111111111111000000000000000000000000000000000000000000
0000000000000000000001100100001222221111111111111111110011000000000000000000000000000000000000000000
0000000000000000000001111000000022221111111111111111110000000000000000000000000000000000000000000000
0000000000000000000111110000000011011111111111111111100000000000000000000000000000000000000000000000
0000000000000000000111111000000001111111101111111111111000000000000000000000000000000000000000000000
0000000000000000000011110000000011111111111111111111111000000000000000000000000000000000000000000000
0000000000000000000001100000100011111111111111111111000010000000000000000000000000000000000000000000
0000000000000000000001000000111010111111111111111000000110000000000000000000000000000000000000000000
0000000000000000000010000000110011111111111111111100000010000000000000000000000000000000000000000000
0000000000000000000010000011111110111111111101111111000000000000000000000000000000000000000000000000
0000000000000000000000000001111100011111111110000101110000000000000000000000000000000000000000000000
0000000000000000000000000001111111111111111111011011111100000000000000000000000000000000000000000000
0000000000000000000000000000001100011111111111111011111110000000000000000000000000000000000000000000
0000000000000000000000000000000111111111111111111000000000000000000000000000000000000000000000000000
0000000000000000000000000000000111111111111111110101000000000000000000000000000000000000000000000000
0000000000000000000000000000000111111111111110000001011110000000000000000000000000000000000000000000
0000000000000000000000000000000011111110000000000111111000000000000000000000000000000000000000000000
0000000000000000000000000000000011111111111111001111111100000000000000000000000000000000000000000000
