0000000000000000000000000022220002222222220022200000000000000000000000000000000002220222222222200000
0000000000000000000000000000222222222222222222000000000000000000000000000002200002222222220222000000
0000000000000000000000000000222222222222222222000000000000000000000000000002222222222222222222000000
0000000000000000000000000222222222222222222220000000000000000000000000000002222222222222222222222200
0000000000000000000000000222222222222222222222002200000000000000000000000000002222222222222222222200
0000000000000000000000000022222222222222222222222200000000000000000000000000002222222222222222220000
0000000000000000000222200022222222200000002222022200000000000000000000000000002222222222222222200000
0000000000000000000222222222222222222222200000000000000000000000000000000000002222222222222222000000
0000000000000000000222222222222222222222222220000000000000000000000000000000000000222222000000020000
0000000000000000002200222022222222222222222210000000000000000000000000000000000000222222222222220000
0000000000000000000200200022222222222222222212110000000000000000000000000000000000222222222222220000
0000000000000000000000002222222222222222222221111000000000000000000000000000000022202222222222220000
0000000000000000000000000222222222222222222222100000000000000000000000000000000002222222222222200000
0000000000000000000000002222222222222222211111200000000000000000000000000000000000222222222222000000
0000000000000000000000002222222222222222211111110111000000000000000000000000000002222222222222200000
0000000000000000000000022022222222222222211111110111000000000000000000000000000002200222222222002200
0000000000000000000000022000022222222222222111111111000000000000000000000000000002200222222222000000
0000000000000000000000020000000222222222222211111111000000000000000000000000000000022222222220000000
0000000000000000000000002202221221222222111111111110000000000000000000000000000000222222222000220000
0000000000000000000000000202221221111212222211111110000000000000000000000000000000000202222200000000
0000000000000000000000000202221222212212211111111111001000000000000000000000000000002202222000000000
0000000000000000000000002222222211112211111112022220001000000000000000000000000000002222220000000000
0000000000000000000000000202211212112111111111111111001000000000000000000000000000000222222200000000
0000000000000000000000022202222211112111111111111111100000000000000000000000000000022202200000000000
0000000000000000000000022222222222111111111111111111111010000000000000000000000000000002000000000000
0000000000000000000000022222222221121111111111111111111111111000011110000000000000000002000000000000
0000000000000000000000022222222222112222211111111111111111111111111100000000000000000000000000000000
0000000000000000000000000022222222222222221111111111111111111111110100000000000000000000000000000000
0000000000000000000000000000222222222222211111211111120111110110011100000000000000000000000000000000
0000000000000000000000002200002222222222211111211111111011111111111100000000000000000000000000000000
0000000000000000000000000222222200222222111111200200011111111110111000000000000000000000000000000000
0000000000000000000000202022222000222222212111200000001111111111011000000000000000000000000000000000
0000000000000000000000222222202000202221111111000000111111111111001010000000000000000000000000000000
0000000000000000000000202220002200002221111000000000111111111111001110000000000000000000000000000000
0000000000000000000000002220002200222222111100000000111111111111011110000000000000000000000000000000
0000000000000000000000000220000200022220002200000000112222211111111111100000000000000000000000000000
0000000000000000000000000000000220002220002002002000112222211111111111100000000000000000000000000000
0000000000000000000000000000002220000222222222222200122221111111101111100000000000000000000000000000
0000000000000000000000000000000000000222222222222200122221111111111111000000000000000000000000000000
0000000000000000000000000000000000000222222222222211112221211111111111000000000000000000000000000000
0000000000000000000000000000000000000002222222222011112222201000110000000000000000000000000000000000
0000000000000000000000000000000000000002222222222222111222111111011111100000000000000000000000000000
0000000000000000000000000000000000022222222222222222222222111111111110000000000000000000000000000000
0000000000000000000000000000000000002222222222222222222221111111111001100000000000000000000000000000
0000000000000000000000000000000000022022222222222222222221111111111000000000000000000000000000000000
0000000000000000000000000000000000022002222222222222222211111111111110000000000000000000000000000000
0000000000000000000000000000020000020222222222222222222211111111111110010000000000000000000000000000
0000000000000000000000000000000000022222222222221111112222111111111110000000000000000000000000000000
0000000000000000000000000000000020020222222222222222211111111221111111000000000000000000000000000000
0000000000000000000000000000000000200222222222222222221121112222112220000000000000000000000000000000
0000000000000000000000000000002222220022222222222222222221222222112222000000000000000000000000000000
0000000000000000000000000000002220020000222222222222222222222221112222222220000000000000000000000000
0000000000000000000000000000000000000000222222222222222222222222222222222200000000000000000000000000
0000000000000000000000000000000000000010222222222222212222222222222022222000000000000000000000000000
0000000000000000000000000000000000000222222222222222212222222222222222222000000000000000000000000000
0000000000000000000000000000000000000212222222222112211222222222222222222000000000000000000000000000
0000000000000000000000000000000000000222222212222211112222222222222222222200000000000000000000000000
0000000000000000000000000000000000000222111211112212222222222222222222222200000000000000000000000000
0000000000000000000000000000000000000221011111112212222112222222222222222200000000000000000000000000
0000000000000000000000000000000000000011111111112222222222222222222222222200000000000000000000000000
0000000000000000000000000000000000001111111111112222222222222212222222220200000000000000000000000000
0000000000000000000000000000000000000111111111112222222222222222222220020000000000000000000000000000
0000000000000000000000000000000000000111111111111222211112222222211100000020000000000000000000000000
0000000000000000000000000000000000000010111111111111111112222222222222000022000000000000000000000000
0000002002200000000000000000000000000001111111111111111111222222222222022222000000000000000000000000
0000021022200000000000000000000000000110111111111111111111212222222222222222000000000000000000000000
0211011222200000000000000000000000000111111111111111111112222222222222222222200000000000000000000000
0211211111222000000000000000000000000011111111111111111112222222222222222222022200000000000000000000
1011111111122001000000000000000000000010111111111111111111222222222222222222022200000000000000000000
1111111111112211000000000000000000000111111111111111111111222212222222220022222000000000000000000000
1111111111111110000000000000000000000111111111111111111111222222222222222022220000000000000000000000
1111111111212122000000000000000000000100111111111111111111112222222200220222000000000000000001100000
1221111111111111100000000000000000000111111111011001011111112122222000000222000000000000000111111110
1111111111111111100222000000000000000111111101001111111111112111000000000222000000000000000011111111
1111111111111111100022000000000000001111111000001111111101112111000000000022000000000000011011111111
1111111111111111122222222222200000011111111001111101111111112211000000000020000000000000111111111111
1111111111111111112222222222220000022221110011111101111111112211110000000000000000000000011111111111
1111111111111111122222222222222000022211110001011100111111102211100000000000000000000000011111111111
1111111111111111122222012221222220222222000000011111111111112211110000000000000000000000001111111111
1111111111111112111222211220222222222122211112211111100111011001110000000000000000000000101111111111
1111111111111122211222222222222222220122221122201221000111011111111000000000000000000000000000000000
1111111111111112222222222222222222222222202022222211001111111111111000000000000000000000000001111111
1111111111111112222222222222222222222222222222222200001111011111110000100000000000000011010000111111
1111111111111112212222222222222222222222222222222001111111111111110000100000000000000000011100111111
1111111111111112222222222222222222222222222222220001111111111111110001100000000000000000111111111111
1111111111111122222222222222222222222222222222222201221111111111000001100000000000000011111111111111
1111111111111122121122222222222222202222222222221122111111111111110011100000000000000011111111111111
1111111112222222121111112212222222222222222222221122111111101111110011110000000000000000010011111111
1111111111222111122222222222222222222222222222221211111111111111111111110000000000000000000011111111
1111111111212111122222222222222222222222222222222211111111111111111111110000000000000000001111111111
1111111111211222211111022222222222200222222222221211111111111111011111100000000000000000111111100000
2111111111112222211112122222222222222222020211122211111111111111111111000000000000000000111111100000
0111111111111221111122222222222222222222222222222211111111111111111111100000000000000000111110000000
0011111111111221111122222222222222022222222222222222111111110000000010011000000000000000000000000000
0001111111111111111222222222222220222222222222222211111111111111111000011000000000000000000000000000
0011111111111111111222222222222222222222222222222222111111111111111111110000000000000000000000000000
0000011111101111122212222222222222000222222222222222211111111111111111111100000000000000000000000000
0000011000101111122222222222222222200002222222222212111111111111111111111000000000000000000000000000
0000001000001011122222222112221222200002222222222211011111101111101111111100000000000000000000000000
0000011100001011122222222111220022200002222222222222221111111111111111111000000000000000000000000000
