0000000000000002222222222121111111111111111211112222212222222220000000002200222222222222222222222222
0000000000000222222222222111111111111111111111122211110002222220000000000222222222222222222222222222
0000000000000000022222221111111111222220220021211111111202222220000000000222222222222222222222222222
0000000000002222222222222111111111111111112111111111122222222220000000000020222222222222220222222222
0000000000022222222222222011111111111111111111111121212112222220000000002000000222220202022222222222
0000000000002000020022222211111111111111122111111111212110220200000000002222022222222222222222222222
0000000000002020022022211111211111111111111111111111112110200222202002002222222222222222222222220000
0000000000000020222222111111111111111111111111111111111111112222222022202222222222222222222222222222
0000000000000002222221111111111111111111011111111111110222112222022222222222222222222222222222222222
0000000000000002222222222222211111101111111111111111111122222000020002222222220220222222222222222222
0000000000000000022022221112211111111111111111111111111122222000000000022200020220222222222222222222
0000000000000000002211211111111111111111111111111111111110022000000000002200022220222222222222222222
0000000000000000000211221211111111111111111111111111111110220000000000000200022222222222222222222222
0000000000000000011111111111111111111111111111222002222010000000000000000000002200022222222222222222
0000000000000000011111111111111111111111111111111111112111100000000000000000000222222222222222202222
0000000000000000111111111211111111111111111111111111122211100000000000000000000002222222022220002222
0000000000000000111111111111111111111111111111111111112001100000000000000000000002222222022222222222
0000000000000000111111111111111111111111111111111111110001000000000000000000002222222200022222200200
0000000000000000010111111111111111111111111111111111111001000000000000000000022222222200222022000000
0000000000000000010111111111111111111111111111111111110001000000000000000000020222202200222222000000
0000000000000000011111221111111111111111111111111111110000000000000000000000222222222002222220000000
0000000000000000111011111111111111111111111111111111111110000000000000000000002222020000202200000000
0000000000000000111111111111111111111111111111100001212200000000000000000000002220000000000000000000
0000000000000011111111101111111111111111111111000222222000000000000000000000000220000000000000000000
0000000000000000011100111111111111111111111111100022002000000000000000000000000000000000000000000000
0000000000000000001000011111111111111111111111020222002200000000000000000000222000000000000000000000
0000000000000000000000011111111111111111111111222222222000000000000002222222222000000000000000000000
0000000000000000000000011111111111111111111121122222222222000000000022222222222000000000000000000000
0000000000000000000000011111111111111111111112122200222220200000000002222220022220000000000000000000
0000000000000000000000010111111111111111111111122222222222222000000002222222222222000000000000000000
0000000000000000000000000001111111111102211222222222222222022200000002222222222222000000000000000000
0000000000000000000001011111111111111111112112222222222222200000022222222222222222002000000000000000
0000000000000000000001111111111111111111112222222212222002222022222222222222002222022200000000000000
0000000000000000000000000001111111111111111111221112222202222222222222222222002222222200000000000000
0000000000000000000000000011011111111111111111111122222222222222222222222222222222222000000000000000
0000000000000000000000000011110111111111111112111222222222221022222222222222222222222000000000000002
0000000000000000000000000011111111111111222222200002222222222222222222222222222222202200000000022202
0000000000000000000000000000111100111111222222222200000220022220222222222222222000002000000000022222
0000000000000000000001100001111111111000222222222222200020111222222220000000000002220000000000002222
0000000000000000001110100001100111011000222222222222222222212222222222222222222222222000000000002222
0000000000000001111111111111111111100000000222222222220000102122222222222222220000000000000000222222
0000000000000000000110110001111111100000000222222222222022222222222222222222020002002222000002222222
0000000000000000000111100111111100100000000222222220222222222222222222222222022222202222200222222222
0000000000000000011111100110000111100000002222202222222222222222222222222222022202200022200002022222
0000000000000000010111100111000011000000222222222222222122222222112222222222222220000222222222222222
0000000000000000011111110000000000000002222222222222221112122222111222222220222222222222222222222222
0000000100001110011111111000000000000000022200012222222221211222211222202220022220222222222222222222
0000000110000111111111011000000000000000022200022222222222211122222222202022000222222222222222222222
0000000011000111111111001100000000000000002201022222221122122221222222222202000222222222222222222222
0000000011110111111111110101100000000000000000022220001111121211111222222222220002222222222222202000
0000000011111111100111111111111110000000000001022221111111020001111122222220000002222222222222222222
0000000001111111111111111111111100000000000000001221111111111101111112222202220022222222222222222222
0000000011111111111111111111111000000000000000022211111111111111111111022222200222222222222222222222
0000000011111111111111111111111000000000000000022221111111111111111111100222200222222222022222222222
0000000011111111111111111111111110000000000000001221111111111111111011110222222022222222222222222222
0000000011111111111111111110111110000000000000001111110111111111111001111122222222222222222222222222
0000000011111111111111111110101100000000000000001111111111111111111111111022222222222222222222222222
0000000001111111111000000011000000000000000000111111111111101111011110011122222222222222222222222220
0000000000111111111111111000000000000000000000111111110111101001111100011022222222222222222222222222
0000000011111111111111111111000000000000000000010000000111100000010000111022222222222222222222222202
0000010110111111111111111100000000000000000000010000000111000000000000000000000222222202222222220002
0000010000011111111111111110000000000000000000010000110100000000000000000000000220222222222222000000
0000000010011111111111111111000000000000000000000000111100000000020000200000000220000222220220000000
0000000001111111111111111111000000000000000000000000000000000002222002200000000220000220200000000000
0000000000111111111111111111000000000000000000000000000000000002222222222200000200000000200000000000
0000000000111111111111111110000000000000000000000000000000000000022022220000000020000000200000000000
0000000000001001110111110110000000000000000000000000000000000000022222200200000000000022220000000000
0000000000000000000110000000000000000000000000000000000000000000002222222200000000000000000000000000
0000000000000000000100000000000000000000000000000000000000020000002222222000000000000000000000000000
0000000000000000110100000000000000000000000000000000000000022220222222222222200000000000000000000000
0000000000000000111100000000000000000000000000000000000000022222222222222200000000000000000000000000
0000000000000000101000000000000000000000000000000000000000022222222222222220022200000000000000000000
0000000000000000101100000000000000000000000000000000000022222222222222222220220200000000000000000000
0000000000000000011110000000000000000000000000000000000222222222222222222222222200000000000000000000
0000000000000000000000000000000000000000000000000000000002222222222222222222222200000000000000000000
0000000000000000000000000000000000000000000000000000000022222222222222222222222000000000000000000000
0000000000000000000000000000000000000000000000000000222222222222222222222222222000000000000000000000
0000000000000000000000000000000000000000000000000000222222222222222222222222222000000000000000000000
0000000000000000000000000000000000000000000000000000220222222222222222222222220000000000000000000000
0000000000000000000000000000000000000000000000000212222222222222222222222222220000000000000000000000
0000000000000000000000000000000000000000000000000221222222222222222200222002220000000000000000000000
0000000000000000000000000000000000000000000000000222222222222222222222222002200000000000000000000000
0000000000000000000000000000000000000000000000000221222222222222222222222222000000000000000000000000
0000000000000000000000000000000000000000000000000011222222222222222222222222200000000001000000000000
0000000000000000000000000000000000000000000000100111222221222222222222222222220000000011000100000000
0000000000000000000000000000000000000001100000110111222221222222222222222222222000000010111100000000
0000000000000000000000000000000000000000000000011121221212222222222222222222222200000111111100000000
0000000000000000000000000000022000000000000000011122221112222222222222212222000000000111111100000000
0000000000000000000000000000222200000011000000111111111112222222222222222222000000001111111000000000
0000000000000000000000000200202222000011000001111111111112222222211122222220000000011111111100000000
0000000000220000000000000222222222000001111111111111111112222222222222211111000111111111100100001000
0000000002220000000000000222022220220001111111111111111112222222220022111111111111111111100011011100
0000000000000000000000022222022222220001111111111111111112222112221222201111111111111111111011011000
0000000000000022222022222222202222222221121111111111111122111122211122221111111111111111111111111001
0000000000000222222222022222222222222222211111111111111222111111111112222111111111111111111111100111
0000000000000022222222222222222222222222211011111111111121111111111122211011111111111111111111101111
0000000000200002222222222222222222222222220111111111111111111111111111111000111111111111111111111110
0000000000000022222222222222202222222022220011110011110011111111111222110000111111111111111101111111
0000000000000022220000002220002000000000000011111111111111111111111111110000001111111111111111111111
0000000000000000000002222222222200000000001111111111111111111111011111100000001111111100000000011100
