1111111111110000000000001110001112122110110000000000000000000000000000000000000000000000000000000000
1111111111111100000000001110011112222122211000000000000000000000000000000000000000000000000000000000
1111111100011100000001111110111222212122222200000000000000000000000000000000000000000000000000000000
1000000000001000000000001222222222222222222200110000000000000000000000000000000000000000000000000000
1111111110000000000000011222222222222222222200210000000000000000000000000000000000000000000000000000
1111111111010000000000002222222222222222222222220000000000000000000000000000000000000000000000000000
1111111111010000000001012222222222222212222222211111000000000000000000000000000000000000000000000000
1111111001111000000222222222221222222222222222222110000000000000000000110000000000000000000000000000
1111111000110000002222220222222222222222222222222100000000000000000001110000000000000000000000000000
1111111111111000000222201222222222222222222222222210000000000000010001111000000000000000000000000000
1111111111000000002122222222222222222222222222221211000000000000010011110000000000000000000000000000
1011111111000000000102222222222222222222222022222220000000000111111111100000000000000000000000000000
0000010111010000001122222222222222111111111002222220000000000011111101100000000000000000000000000000
0000000001000011111112221222222222222222222112212220000000000011111111100000000000000000000000000000
0000000000000001011111111222202222222222222112221100000000000000111011110000000000000000000000000000
0000000000000000000112211111222222222222221111020000000011100011110111100000000000000000000000000000
0200000000111111000111111111111122222222222222000000000011111111110111000111000000000000000000000000
2200000000101111111111111211211122222222222221100000000011111111111111111111000000000000000000000000
2200000000000111111111111111211112222222222111100000000001111111011100011111100000000000000000000000
2220020000000111111111111111111112222222222200000220000011111111111110111111100000000000000000000000
2022220000000111111111111111111111222222222000002222000011111111111110111111100000000000000000000000
2222022000000111111111111111112121122222222200002220000011111111111111111111110000000000000000000000
2220020000000101111111111111111111122222222110202222001111111111111111111111110000000000000000000000
2222000000110101011111111111111111222222222100222021111101111110220001111110011002200000000000000000
2222020000011001011111111111111211222222220022021111111111111111111120011111111022200000000000000000
2222020000010000000000102111111221122222222022220210011111111111111111001111112222200000000000000000
2222222000000011111111111111111222222222222222110211101111111111111111000221111022220000000000000000
2222222220000011111111111111111112222222222222222221111011111111111121122222221122220000000000000000
2222222222000011111111111111111111222222222222222211111111111111111111112111211222222000000000000000
2222222222211111111111111111121112220000200000002211101111111111111111122221211222022000000000000000
2222222222201110001111111011122122222222222222022222211111111011111111222202222222022000000000000000
2220000222221221000111111111122222222222222222022222020101111111111111222222222222222200000000000000
2222220002220220000111111111122222222222222222000000000111111111111111222222222222220000000000000000
2222222200000000001111111211112022222222222222000000000111110111111112222222222222220000000000000000
2222222222222222201111111121111022222222000002000000000111110011111111222222222222220000000000000000
2222222222222122111111111121111022222222000000220000000011110001021222222222222222220000000000000000
2222222222222002211111111222200222222222000000020000000001101000022222222222222222222000000000000000
2222222222022012221111111112222220222222000000000000000111111100022220002220000222222000000000000000
2222222222222201222111111022222222222222200000000000001111001100000020022222222222222200000000000000
2222222222222222222211110022220222222222220000000000000000000000002000022222222222222000000000000000
0022222222222222220111222222220220222222022000000000000000000000002002022222222222222220000000000000
0000022222202222220221222222222222220022220000000000000000000000022222222222222222222222000000000000
0000002222200022222222222222222222220000220000000000000000000000002222222222222222222222000000000000
0000000222000022222222222222222222222000220000000000000000000000000220222222222222222222000000000000
0000002222000002222222222222222222220000000000000000000000000000000222222222222222222222200000000000
0000002200000122222222222222222022220000000000000000000000000000000022222222222112220222200000000000
0000000200001122222222222222222000122100000000000000000000000000001000000222222111222202000000000000
0000000000001022222222221110100002111220000000000000000000000000011110002222221112202202200000000000
0000000000000022222222222222222112222220000000000000000000000111111110022111221122222222200000000000
0000000000000022222222222222222212110000000000000000000000000111111110221112222111112220200000000000
0000000000000001122222222222222221122220000000000000000000000010011111111111101111122222000000000000
0000000000000001122222222222222221110100000000000000000000000000011111111111111111110220000000000000
0000000000000001122222222222212111110000000000000000000000000000011111111111111111111120000000000000
0000000000000012122222222222221111111100000000000000000000000000111111111111111111111100000000000000
0000000000000002221221211222221111100000000000000000000000000101111011111111111111111200000000000000
0000000000110102111111211222220000001000000000000000000000000001111111111111111211111100000000000000
0000000000011100111111111111111111110000000000000000000000001101111111111111111111111111000000000000
0000000000010111111111111122221111110000000000000000000100000100011111111222221111111110000000000000
0000000000000111111111111112111111110000000000000000111100000111000001111111121111111110000000000000
0000000000111111111111111111111111110000000000000000111110011111111111111111111111111110000000000000
0000000010011111111111111111111111100110000000111000111110011111111111111111111111111010000000000000
0000000111000001111111111111111110000000000000110001111111110111111111111111111111111000000000000000
0000000111101111111111111111111111000000000001111111111111110111111111111111111111111000000000000000
0000000011111111111111111111111110000000000000111111111111111111111111111111111111111000000000000000
0000000000111111111101111111111101000000000000111011111111111111111111111111111111111000000000000000
0000000011110111111111111111111101100000000011111111111111111111111101111111112111011011101110000000
0000000011110111111111111111111100100000000111111111111111111111101111111111111111101111101100000000
0000000111111111111111111111111111110000000011111111111111111111111111100001111110101110111110000000
0000000001000111111111111111111111110000000000000000011100001111111101100001111100011111110000000000
0000000000001111111111111111111111110000000000111111111111111111110100111001111100000111110000000000
0000000000000111111111111112110001000000000001111111111111111111111100000000111111000111110011000000
0000000000000111111111111112200000000000000001011111111111111011111111000000010111111111111111000000
0000000000000111111111111102200000000000000001011111111111111110011110000000010011111111111111100000
0000000000000011111111102222222200000000000000011111111111111111000110000000100001111111111111100000
0000000000000001011111102202220000000000000000011111111111111111111110000000110111111111111111110000
0000000000000011111111111022222000000000000000000111111111111111110000000000011110111111111111111000
0000000000000011111111111022220000000000200000010011111111111111111100000000011111111111111111111000
0000000000000001111111110112200000000000000000011111111111111111111000000000110111111111111111111110
0000000000000000111001011122200222000000020010011111111111111111111100000000010111121111111111111111
0000000000000000000001110222222220000000000211011111111111111111111100000000000111122212211111111111
0000000000000000000000122222222200000000002211000111111110000011000000000002000222211111111211111111
0000000000000000000022222222222222000002022201111111111111111111111000000222221111111111111111111101
0000000000000000000000222222222222022202222201111120111111111110111000000222221111111111111111111110
0000000000000000000000220222222222022222222221211221111111111111111000002222222111111111111111111111
0000000000000000000000222222222222020222222222000011111111111111110000002222222121111111111111111111
0000000000000000000000222222222222222222222222000111111111111111111000022222222122212111111111112211
0000000000000000000002222222222222222222222222211111111111111110100000022222222222222111111111200210
0000000000000000000000200222222222222222222222222011111111111111100000022222222222222211111122220000
0000000000000000000000222222222222222222222222222021121211111110000002002222222222222211111111220000
0000000000000000000000202222222002222222222222222211111111111111000002002222222222222111111111220000
0000000000000000000000000002222222222222222222222221111112111110000002022222222222000001111111220000
0000000000000000000000000022222222222222222222222220100111111011000022222222222222222221111111100000
0000000000000000000000000022222222222222222222222222122111120001000220222222222222222222221221000000
0000000000000000000000000022222222222222222222222222220111000000000222222222222222222222222200000000
0000000000000000000000000222222222222222222222222222220211000000000222220022222222220220222220000000
0000000000000000000000000002222222222222222222222222222222000000000222222220222222222220220200000000
0000000000000000000000000002222222222222222222222222200201000000000022222002222222222220222200000000
0000000000000000000000000002220222222222222222200000020000000000000000222022222222222222222200000000
0000000000000000000000000002222222222222222222222222220000000000000000222222222222222222222200000000
0000000000000000000000000000222220222222222222222202222000000000000000020222222000222222222200000000
