0000000000000000000000000000000000000000022200000000000000000000000000000000000000000000000222222002
0000000000000000000000000000000000000000022220000000000000000000000000000000000000022220022222222222
0000000000000000000000000000000000000002222222000000000011000000000000000000000000022222222222222222
0000000000000000000000000000000000000000222222000000001110000000000000000000000002222222222222222222
0000000000000000000000000000000000000002222222000000001110000000000000000000000022220222222222222222
0000000000000000000000000000000000220002222222000000001110000000000000000000000000222222222222222222
0000000000000000000000000000000000222000222222000000101110000000000000000000000000022222222222200000
0020200000002000000000000000000000222200222222200001111010001000000000000020000000002222222222222220
2222200000002000000000000000000000000200022220111222111100011100000000002220020220002222220222222220
2222200000022000000000000000000000022220022222211112111110111000000000002220222200000002220222222222
2222200000002000000000000000000000022220022222211111111110011000002222222222202200000022220022222222
2222200200022000000000000000000000022222222222111111221110011111002222222202222220000022222222222022
2200200202202000000000000000000000020222112222221111111110011111122222222222222000000222202222222222
2200200202200000000000000000000000022222111112121112111111211111022222222222222200200000002022222222
2200000222222000000000000000000022020221111111120111111111111111122222222222222222220022022222222200
2202000222220000000000000000000022000211111111111111111111111112122222222222222222222000022002222200
2222222220000000000000000000000021112211111111111111111111111112222222222222220222222020022222222200
2222222220020000000000000000000022211111111111111111111111111111222222222222222222222222222000222200
2222222220000000000000000000000022211111111111211111111111111111122122222222222222222222222222222222
2222222220200000000000000000000022211112111111111111110022221121111122222220222222222222222222000222
2222222200000000000000000000000002201111111111111111111111122222111111110220222222200222222222000220
2222222222000000000000000000000000211111111111111111111111111111111112222112221111120000222222200000
2222222000000000000000000000000000011111111111111111111111111112222222222111122111122222222222200000
2000000002200000000000000000000001111111111111111111111111111112222222222211111111222222222222220000
2222222222220000000000000000000001111111111111111111111111111122222222221121111111100010022222000000
2222222222222200000000000000000001111111111111111111111111111122222211121111111111112112000022222000
2222222222220000000000000000000011111111111111111111111111111220222211111111111111111111112222222220
2222222202222000000000000000000011111111111211111111111110111220222112222111111111111111112220222222
2222222222222000000000000000011111111111111111111111111111122020222211222111111111111111122020022222
2222222222222000000000000001011111111111111111111111111110220000022221111112111111111111122220022222
2222222202222202000000000001111111111111111111111111111110020000022221111111111111111111222222222222
2222022220222202200000000000001111111011111111111111111100020000022221111111111111111111111120222112
2222222222222222200000000000001111111111111110111111110100000000022222111121111111111111111111111112
2222222220222222220000000000001101100011111111110111000000000000000202111111111122222222221122222222
2222222222222222220000000000000001001111111111111111000000000000000111111111111111111111122222222222
2222222222222222200200000000000000100111111111111110000000000000000111111111111111111112111122222222
0222222222222222202202000000000000110111111111101010000000000000000110111011111111111111112222220000
0222222222222222222222000000000000111101111111100000000000000000001111111211111111111111111111112220
2222222222222222222200000000000000011110111111100000000000000000001111111111111111111111111111212222
2222222222222222222200000000000000000111111111100000000000000000001010111111111111111111021111212222
2222222222222222222000000000000000001111101101110000000000000000001011111111111111111111121112222222
2222222200000000000000000000000000000111111011010000110011000000000111111111111111111111111112222222
0222222222222222200000000000000000000011100110110001111111000000000111110000111111111111111112222222
2222222222222222000000000000000000000000000111110001111100000000000000110001111111111111112222222220
2222222222222222200000000000000000000000000011100101111110000000000000110001111111111111111222222220
2222222222222222222000000000000000000000000011011111111110200000000000110000011011111111112222222220
2222222222222220220000000000000000000000101111011111111112202000000001111100000111111111110222222220
2222222222222222220000000000000000000000011111111111111111212000200011111111110111011111110222220220
2002222222222220000000000000000000000000111111111111111111111222200000111111111111111110000022200000
2202022222220000000000000000000000000000011111111111111112111110000000111111111111111110000022200000
2222222222220000000000000000000000000000011111001111111111111110000002000001111111111101011112200000
2222222222222000000000000220000000000000001000011111111111122210111222200011111111111111111102000000
0222222222222200000000020222220000000000111000000111111111121110112222002211111111111111111000000000
0222200222222222220002022222220000000000000000001111111111122211112222222011111111111111111000000000
0022000222222220000022000222022000000000000000001111111111122222200002200011111111111111111000000000
0000000222200022000022000022220000000000000111111111110222222222211222220011121111111111111000000000
0000000222200022000220222022222200000000000011111111111111222222222222200011122221111111111000000000
0000000022220222222022222022022220000000011111111111111111222222222222200011222110000001111000000000
0000000002220000220002200022002200000000011111111111111111111222102222002222211111111100001000000000
0000000000000000000200220022022200000000011111111111111111111221122220002222211111111111100000000000
0000000000000222222222222222222200000000011111111111111111111121221222222222211111111111100000000000
0000000000000022222222222222222220001100001111111111111111112222222222222222211111111111110000000000
0000000000000000222222222222222222200100001111111111111111122212222222222222211111111111100000000000
0000000000000002222222222222222222200100000111111111111122222122222222022222221111111111110000000000
0000000000000002222222222222222222222220001111111111111122222222222222222222222222111111100000000000
0000000000000002222202222222222222222221001111111111111111222222222222222222222222221111100000000000
0000000000000022022222222222222222222220011111111111111111111222222222222222222222201111110000000000
0000000000000222222222222222222222222211111111111112212211111122222222222201222222111111100000000000
0000000000000022222222222222222222222221111111111111111121122122222222222200222222100000000000000000
0000000000000222222222222222222222212211111101111111111111111122222222222222222222200000000000000000
0000000000000022002222222222222222220000111100111111111111111222222222222222222222100000000000000000
0000000000000200022222222222222222222222111101111111111122211222222222222222222222110000000000000000
0000000000000222222222222222222222222222221111111111101221212222222222222222222221100000000000000000
0000000000000222222222222222222222222202221111111111212221122222222222222222200022000000000000000000
0000000000000022222222222222222222222222221001111111111222222112222222222222200000000000000000000000
0000000000002222022222222222222222222222211211111111111111121111222222222222220000000000000000000000
0000000000000022222220222222222222222222201111221221111111111112222222222222000000000000000000000000
0000000000000000222220222222222222000000000111121122111111111122211222222222220000000000000000000000
0000000000000000020222222222222222200000001111111111111111111112211101122220220000000000000000000000
0000000000000000022222222222222200222000001111111111111111111111111222222222220000000000000000000000
0000000000000000000222222222222200222200000110111111121122211121211222222222120000000000000000000000
0000000000000000000022220022222200020000000101100011211111111111111222222222111110000000000000000000
0000000000000000000000200022222200000000000001110011111111111111111222221211111111000000000000000000
0000000000000000000000000000000000000000000001000011111111111111111222221111111111000000000000000000
0000000000000000000000000000000000000000000000001110111111111111112122222111101111000000000000000000
0000000000000000000000000000000000000000000000000111111111111111111222212211111211000000000000000000
0000000000000000000000000000000000000000000000000100111111111111222222221220112110000000000000000000
0000000000000000000000000000000000000000000000000001111111112211222222222221112110000000000000000000
0000000000000000000000000000000000000000000000000001111111111222222221222222221111100000000000000000
0000000000000000000000000000000000000000000000000001101102222222222222222002222000000000000000000000
0000000000000000000000000000000000000000000000000011111112222222222222111111112221000000000000000000
0000000000000000000000000000000000000000000000000001111110222222222222111111001111000000000000000000
0000000000000000000000000000000000000000000000000001100010222222222222211111111111000000000000000000
0000000000000000000000000000000000000000000000000000000110222122222222211111100011000000000000000000
0000000000000000000000000000000000000000000000000000001110201122221111111111111110000000000000000000
0000000000000000000000000000000000000000000000000000001000001111111111111111111110000000000000000000
0000000000000000000000000000000000000000000000000000001000111111111111111111100100000000000000000000
0000000000000000000000000000000000000000000000000000000000110110011111111111001000000000000000000000
0000000000000000000000000000000000000000000000000000000000000000111111110111001100000000000000000000
0000000000000000000000000000000000000000000000000000000000000000001111100111000000000000000000000000
