0000000000000000000000000000000000000000202200111111111111222211111111111110000010000000000000000000
0000000000000000000000000000000000000000222000011111111111222211111111111110001010000000000000000000
0000000000000000000000000000000000000002222001111111111111111111111111111110111111000000000000000000
0000000000000000000000000000000000022221100211121111111111112111111111111111100100000000000000000000
0000000000000000000000000000000000000221122211111111111111111111111111111111100111010000000000000000
0000000000000000000000000000000000000111111111111111111111111111111111111111111111110000000000000000
0000000000000000000000000000000000000001111211111111111111111111111111111111101111000000000000000000
0000000000000000000000000000000000022202221111111111111111111111111112211111100000000000000000000000
0000000000000000000000000000000000022222221111111111111111111211111111111111110000000000000000000000
0000000000000000000000000000000000022222221111111111111111111111111111111111100000000000000000000000
0000000000000000000000000000000000002222221111111111111111111111111111111111110000000000000000000000
0000000000000000000000000000022222202222211111111111111111111111111111111111110000000000000000000000
0000000000000000000000000000222200220222221111111111111111111111111111111111110000000000000000000000
0000000000000000000000000000022000222222021111111111111111111111111111111111111100000000000000000000
0000000000000000011001000000000022222222112111111111111111111111111111111111011100000000000000000000
0000000000000000111110000020002222222111111111111111111111111111111111111111011000000000000000000000
0000000000000000011100000020022222222211111111111111111111111111111111111111101000000000000000000000
0000000000000001011101000022222222222201111111111111111111111111111111110011101000000000000000000000
0000000000000011111111110022220002222221111111111111111111111111111111111000000000000000000000000000
0000000000010111111111000002220022222222111111111111111111222111111111100000000000000000000000000000
0000000000011110111110000000200002222222111111111111111111112111111111000000000000000000000000000000
0000000000001111111111111100000222222222121111111111111111111111111111110000000000000000000000000000
0000000011101111111111111110000220002222221111111111111112211111111110000000000000000000000000000000
0100000011111111111111111110000000002022111111111111111112211111001111000000000000000000000000000000
0111000011111111111111110000000000002221111111111121111111211111001100000000000000000000000000000000
0111000111011111111111110000000000022221111111111111111112111112000000000000000000000000000000000000
0111111111011111111111110000000000022222211111211211111111211111222000000000000000000000000000000000
0111111111111111111111110000000000022222211111222211122111112111222200000000000000000000000000000000
0011111111111111111111110010000000022011111111222221121112112111220000000000000000000000000000000000
0011111111111111111111111110000000000011111122222221221111011111000000000000000000000000000000000000
0001111111111111111111111100000000001111111122112222211112222122200000000000000000000000000000000000
0000011111111111110001111110000000111111121222222222111111222222220000000000000000000000000000000000
0000011111111111111111111100000001111111122222222222222112222222220000000000000000000000000000000000
0000011111111111111111111000000011111111112222222022222222222222220000000000000000000000000000000000
0011111111111111111111111100000011111111122122222022202222222222220000000000000000000000000000000000
0000001111111111111111111100001111111111112112222222222222220221110000000000000000000000000000000000
0000000111111111111111111110001011111111111111122222222222222222220000000000000000000000000000000000
0000000111112211111111000000000111111111111111111022222222220000220000000000000000000000000000000000
0222200111122211111111110010010111111111111111101222222222200000000000000000000000000000000000000000
2222221111122111111111110011110111111111111111101222222202000000000000000000000000000000000000000000
0222222211121111111111111001110111111111111111122222222222000000000000000000000000000000000000000000
2222222221211112111111110001111111111111111111102222100000000000000000000000000000000000000000000000
2222222222211112111111100000011111111110000000002202200000000000000000000000000000000000000000000001
2222222222212221211110000000011111111111111111112000000000000000000000000000000000000000000000000011
2222222222222222222000000000000111111111111111111000000000000000000000000000000000000000000000000111
2222222222222222222000000000000111111111111111111000000000000000000000000000000000000000000000011111
2222222222222222222100000000000101111111111111100010000000000000000000000000000000000000000000111111
2222220000000022221100000000000111111111111111100000000000000000000000000000000000000001000001111111
2222222222222000022200000000000111111111111111000000000000000000000000000000000000000001111111011111
2222222222222222000000000000011111110111111111000000000000000000000000000000000000000001111011111111
2222222222222222220000000000111011111111111110000000000000000000000000000000000000000001111111111111
2222222222222222000220000000011111110111111111000000000000000000000000000000000000000011111111111111
2222222222222200002000000000011111111111111111000000000000000000000000000000000000000010011111111111
2222222222220220000000000000000001111111100110000000000000000000000000000000000000000011011111111111
2222222222222220000000000000000001111111100111000000110000000000000000000000000001011111111111111111
2222222222020000000000000000000000111111100001111111100000000000000000000000000001111011111111111111
2220222222220000000000000000000001111111100011111111000110000000000000000000000001110000000000000000
0020222222000000000000000000000000011111111111111111000110000000000000000000000000101100011111111111
2222222220220000000000000000000000001111111111111111100111100000000000000000000000100000111111111111
2022222222222000000000000000000000001111111111111111110111110000000000000000000000101111111111111111
0022222222220000000000000000000000001111111111111110111111100000000000000000000000001111111111111111
2222222222200000000000000000000000011111111111111111111110000000000000000000000000000111111111111111
0222022222000000000000000000000000011111111111111111100101100000000000000000000000000110110111111111
0000222200000000000000000000000001000011111111111111111111110000000000000000000000001110101100001111
0000222200000000000000000000000010011001111110000000111111110000000000000000000000001110111011001111
0000002222000000000000000000000000001111111111111111111100000000000000000000000000000000111111111111
2000002222000000000000000000000001011111111111111111110110000000000000000000000000000000000111111111
2202002200000000000000000000000001111011111111111111111100000000000000000000000000000000001100111111
2222222000000000000000000000000001100011111111111111111100000000000000000000000000000000000000111111
2222222000000000000000000000000000001111111111111111111110000000000000000000000000000000000000111110
2222222000000000000000000000000000001111111111111111111110000000000020000000000000000000000000110011
0222222200000000000000000000000000011011111111111111100011000000000222200111010000000000000000010011
2220022200000000000000000000000000011111100111111110000000000000002222020111110000000000000000000000
2222222202220000000000000000000000011111001111111111000000000000002212000111110000000000000000000000
2222222222220000000000000000000000011111011111101111100001100000012222011100110000000000000000000000
2222222222222000000000000000000000111011010111111111100001000000010221221000011000000000000000000000
2222222222220000000000000000000000000011100111111111110001100100011222221111111100001000000000000000
2222222222222002022000020000000000000011111011111111111011100111222222221111110000001000000000000000
2222202222222022222002220000000000000000011111111111110111111111222222221111110001111000000000000000
2222222222220022222222222002000000000000011111111111111101101111222222222111110001110000000000000000
2222222222222202222222222222000000000011111111110011111101111111222222221111111011111000000000000000
2222222222222222222222222222000000000000111111111111111111211112222222222211111111111111100000000000
2222222222222222220202222220000000000000111111111111111111222022222222222221111111111111100000000000
2200000002222222222220222220000000000000111111111111111112212222222222222221111111111111000000000000
2222222222222222222222222020000000000000111111111111112222212222222222221220001001011110000000000000
2222222222222222222222022000000000000000011110000111112222222222222222222222100000001000000000000000
2222222222222222222222222200000000000000011110111111000222222222222222222222221111100000000000000000
2222222222222222222222222200002202001100011110011011111222222222222222222222221111100000000000000000
2222222222222222222222222200002222000101011111111111111111222200002002222222222110000000000000000000
2222222222222222222222222222222200000111111001111111111111111102222222222222222210000000000000000000
2222222222222002222200222222022000000111100001111111111122222222222222222221122001100000000000000000
2222222222202222222222222222202200001100100001111111111222222222222212222211111101100000000000000000
2222222202222222222222202222222200001110111111111111022122222222222222222222111111000000000000000000
2222222222222222222222220222000000011010011111111111112222222222222222222221111111000000000000000000
2222202222222222222222222222000000000010111110111111222222222222222222222222111100110000000000000000
0022022222222222222222222200000000000000111111111111112111112220222222222122111100000000000000000000
0000002222222222222222222220000000000011111111111011112010222222222202222222111000000000000000000000
0000022222222222222220222222000000000000000011111000122211122222022222222210111100000000000000000000
0000002022222222222222222222200000000000000000110011111110002200002222222110001110000000000000000000
0000000000222222220020022222200000000000000000000000111110000200000222222210001110000000000000000000
